WE ./textures/cute.png
SO ./textures/fortress.png
NO ./textures/moss.png
EA ./textures/wall.png

F 220,111,119
C 225,111,0

 1111111111111111111111
10000000001110000000000111111111111111111
 1000000000100000000001         1011111
  10000000000000000001          100011
   100000000000000001          10011
    1000000000000001          11111
     10000000000001    11    1111 
      100000000001    1001  111
       100000000001  10011111
        10000000000110001011
         100000000000000101
          1000000000000001
         100000N000000111
        100000000000001
       10000000000000001
        100000000000001
         1000000000001
          10000000001
           100000001
            1000001
             11111
