



WE ./textures/cute.png
SO ./textures/fortress.png
NO ./textures/moss.png
EA ./textures/wall.png

C 0,0,0
F 47,82,65

                 1            1
                111          111
               10001        10001                   1
              1000001      1000001                11111
             100000001    100000001             111000111
            10000000001  10000000001           10000000001
           10000000000011000000000001         1000000000001
          1000000000000000000000000001       100000000000001     1
         100000000000000000000000000001     10000000000000001   111
        10000000000000000000000000000001   1000000000000000001 11011
        1000000000000000000000000000000011100000000000000000001100001
        10000000000000000000000000000000000000000000000000000000000001
        10000000000000000000000000000000000000000000000000000000000001111
        10000000000001111100000000000001111111000000000000000100000000001
        1000000000001     1000000000001       110000000000001 100000000001
         10000000001       10000000001          100000000001   100000000001
          100000001         10000000001          1000000001     10000000001
           1000001           100000001            100000001      1000000001
           1000001           1000000001            10000001       1100000001
           1000001           1000000001             10000001        111100001
          100000001         100000000001           1000000001         10000001
         10000000001       10000000000001         100000000001       1000000001
        1000000000001     1000000000000001       10000000000001     100000000001
       100000000000011111100000000000000001     1000000000000001   10000000000001
      10000000000000000000000000000000000001   100000000000000001 1000000000000001
      10000000000000000000000000000000000001  1000000000000000001110000000000000001
      100000000000000000000000000000000000001100000000000000000000000000000000000001
       100000000000000000000000000000000000000000000000000000000000000000000000000001
       1000000000000000000000000000000000000000000000000000000000000000000000000000001
       1000000000000000000000001000000000000000000000100000000000001000000000000000001
        10000000000000000S00001 100000000000000000001 1000000000001 10000000000000001
         100000000000000000001   1000000000000000001   10000000001   100000000000001
          1000000000000000001     10000000000000001     100000001     1000000000001
           11000000000000001       100000000000001       1000001       10000000001
            100000000000001         1000000000001         10001         100000001
             1000000000001           10000000001           101           1000001
              10000000001             100000001            101           1000001
               100000001               1000001             101           1000001
               10000000111111111111111110000011111111111111101111111111111000001
               10000000000000000000000000000000000000000000000000000000000000001
               10000000000000000000000000000000000000000000000000000000000000001
               11111111111111100000001111111111111110000001111111111111110000111
               10000000000000000000000000000000000000000000000000000000000000001
               10000000000000000000000000000000000000000000000000000000000000001
               11111111111111111111111111111111111111111111111111111111111111111